1;Harry Potter and the Philosopher's Stone ; J. K. Rowling 
2;Harry Potter and the Chamber of Secrets  ; J. K. Rowling
3;Harry Potter and the Prisoner of Azkaban  ; J. K. Rowling
4;Harry Potter and the Goblet of Fire  ; J. K. Rowling
5;Harry Potter and the Order of the Phoenix ;  J. K. Rowling
6;Harry Potter and the Half-Blood Prince  ; J. K. Rowling
7;Harry Potter and the Deathly Hallows  ; J. K. Rowling
8;The Fellowship of the Ring ;	J. R. R. Tolkien
9;The Two Towers ;	J. R. R. Tolkien
10;The Return of the King ;	J. R. R. Tolkien
11;Digital Fortress ; Daniel Gerhard Brown
12;Deception Point ; Daniel Gerhard Brown
13;Angels & Demons ; Daniel Gerhard Brown
14;The Da Vinci Code ; Daniel Gerhard Brown
15;The Lost Symbol ; Daniel Gerhard Brown
16;Inferno ; Daniel Gerhard Brown
17;Don Quixote ; Miguel de Cervantes
18;A Tale of Two Cities ;Charles Dickens
19;Alice in Wonderland	; Lewis Carroll
20;The Tale of Peter Rabbit ;	Beatrix Potter
21;The Odyssey ;	Homer
22;To Kill a Mockingbird;	Harper Lee
23;Kane and Abel;	Jeffrey Archer
24;In His Steps: What Would Jesus Do?;	Charles M. Sheldon
25;Gone with the Wind;	Margaret Mitchell
26;The Purpose Driven Life;	Rick Warren
27;The Revolt of Mamie Stover;	William Bradford Huie
28;The Girl with the Dragon Tattoo;	Stieg Larsson
29;Who Moved My Cheese?;	Spencer Johnson
30;The Great Gatsby;	F. Scott Fitzgerald
31;The Wind in the Willows;	Kenneth Grahame
32;1984;	George Orwell
33;The 7 Habits of Highly Effective People;	Stephen R. Covey
34;The Celestine Prophecy;	James Redfield
35;The Hunger Games;	Suzanne Collins
36;The Shack;	William P. Young
37;The Godfather;	Mario Puzo
38;Love Story;	Erich Segal
39;The Happy Hooker: My Own Story;	Xaviera Hollander
40;Jaws;	Peter Benchley
41;Love You Forever;	Robert Munsch
42;The Women's Room;	Marilyn French
43;Pride and Prejudice;	Jane Austen
44;The Secret;	Rhonda Byrne
45;Fear of Flying;	Erica Jong
46;Dune;	Frank Herbert
47;Charlie and the Chocolate Factory;	Roald Dahl
48;The Horse Whisperer;	Nicholas Evans
49;Goodnight Moon;	Margaret Wise Brown
50;The Fault in Our Stars;	John Green
51;The Poky Little Puppy;	Janette Sebring Lowrey
52;The Girl on the Train;	Paula Hawkins
53;God's Little Acre;	Erskine Caldwell
54;The Prophet;	Khalil Gibran